obtain (v): đạt được cái gì

make it: thành công
    Yes, I make it: tôi đã làm được điều ấy
    you made it:

have impact/influence/effect on 

so that: để mà
    people should be told about the things that threaten the safety of wildlife so that they can avoid doing them

contamination: ô nhiễm

be derived from = originate from: có nguồn gốc từ

lead to : dẫn đến
    toxic chemicals from factories are one of the serious factors that lead wildlife to the verge of extintion

on the verge of extintion: trên bờ vực tuyệt chủng

take measures: thực hiện hành động

conservative group: nhóm bảo tồn

wholehearted: tận tâm

at heart = by nature: về bản chất

lie at the root of = heart

be exposed to: tiếp cận với

over-exploitation for food, pets, and medicine pollution, and diseaseare recognized as a serious threat to extintion

dispute: tranh chấp

be dedicated to = be devoted to = be commited to + ving

crucial = very important

bolstered :ủng hộ, tấm nền

at an unprecedented rate: không có tiền lệ

vulnerable >< invulnerable

commerce: thương mại

reserves: khu bảo tồn

degradation: sự suy giảm, suy đồi  = deterioration

do harm to = do good to = 
do more harm than good: gây hại nhiều hơn có lợi 

terrestrial

threatened specicies = endangered species

result in = lead to: dẫn tới

exotic plant speccies: loài vật lạ 

revolted: cuộc nổi loạn

a number of = many











